00 00 00 00 00 00 00 00 00 00 00 00 00 00 00 00 
00 02 02 01 02 02 02 02 00 02 02 00 01 02 00 00 
00 02 02 02 02 02 02 02 02 02 02 04 04 05 01 00 
00 02 02 02 03 02 03 03 03 03 03 03 03 06 02 00 
00 02 02 02 02 02 02 02 08 08 08 03 03 06 00 00 
00 02 02 02 02 01 02 02 02 02 00 00 03 06 01 00 
00 02 02 02 01 01 05 01 02 00 01 00 03 06 02 00 
00 02 02 02 02 00 07 02 00 01 02 00 03 06 00 00 
00 00 02 02 00 01 02 00 01 02 00 00 03 06 01 00 
00 01 00 02 04 02 04 05 02 00 01 00 08 07 02 00 
00 02 00 02 02 02 08 07 00 01 02 00 01 02 00 00 
00 00 00 00 00 00 00 00 00 00 00 00 00 00 00 00 
